NO ./imgs/north.xpm
SO ./imgs/south.xpm
WE ./imgs/west.xpm
EA ./imgs/east.xpm

F 220,100,0
C 225,30,0

1111111111111111111111111
1000000000110000001000001
10110X000111000000N000001
100100Z000000000000000001
1111111110110000011100001
100000000011000001110111111111111
111101111111110111000000000011011
1111011111111101110101x010X011011
110Z00001101010111000000100011011
100000X00000000011000Z0010Z011111
10x00000000000001101010010001111
11000001110101011111011110001011
1111Z11111101011011110100011111
111111111111111111111111111111
