NO ./imgs/north.png
SO       ./imgs/south.png
WE ./imgs/west.png
EA ./imgs/east.png


F 0,100,0
C 70,130,180


111111
1000N111111
100000000001
100000000001
100000000001
100000000001
100000000001
100000000001
100000000001
101101111111
111111