NO ./imgs/north.png
SO ./imgs/south.png
WE ./imgs/west.png
EA ./imgs/east.png


F 0,100,0
C 70,130,180


111111
10001111111
100000000001
10000000011
1110011000011
100000000001
1000N0000001
100000000001
10000000001
10111111111
111111