



        111111111111111111111111
        100000000011000000001001
        1011000001100000W00F10001
        100100F000D00F0F010000001
111111111D11000001110000010F0F001
10000000001100000111D1111111111D1
11110111111111011100000000001 101
1111D111111111D11101F10010001 101
11000000110101011100F00010F01 101
10000000000000000000F00010001 101
100000000000000011011100100011 11
1100000111010101111101111000101
110111111101011111111010001111
11111111 1111111 111111111111   1