






        1111111111111111111111111
        1000000000110W00000001001
        1011000001100000000F10001
        100100F000D00F0F01000000111111
111111111D11000001110000010F0F00100000
10000000001100000111D1111111111D100000
11110111111111011100000000001 10100000
1111D111111111D11101F10010001 10100000
11000000110101011100F00010F01 10111111
10000000000000000000F00010001 111
100000000000000011010100100011  1
1100000111010101111101111000101
110111 1110101 10111101000111
11111111 1111111 111111111111   1