NO textures/edited/wallN.xpm
SO textures/edited/wallS.xpm
WE textures/edited/wallW.xpm
EA textures/edited/wallE.xpm

F 220,100,0
C 225,30,0

1111111111111111111111111
1000000000110000001000001
101100000111000000N000001
1001000000000000000000001
1111111110110000011100001
100000000011000001110111111111111
11110111111111011100000000001 101
11110111111111011101010010001 101
11000000110101011100000010001 101
10000000000000001100000010001 111
100000000000000011010100100011	1
1100000111010101111101111000101
11110111 1110101 10111101000111
11111111 1111111 111111111111
