NO ./imgs/north.xpm
SO ./imgs/south.xpm
WE ./imgs/west.xpm
EA ./imgs/east.xpm

F 220,100,0
C 225,30,0

1111111111111111111111111
1000000000110000001000001
101100000111000000N000001
1001000000000000000000001
1111111110110000011100001
100000000011000001110111111111111
111101111111110111000000000011011
111101111111110111010100100011011
110000001101010111000000100011011
100000000000000011000000100011111
10000000000000001101010010001111
11000001110101011111011110001011
1111011111101011011110100011111
111111111111111111111111111111
