NO ./imgs/zzz.xpm
SO ./imgs/cute_2.xpm
WE ./imgs/cute_3.xpm
EA ./imgs/cute_4.xpm

F 0,100,0
C 70,130,180


        111111111111111111111111
        100000000011Z00000001001
        1011000001100000W0001x01
        10x1Z00000D000000100000Z1
111111111D110000011100ZZ0100X0001
10x00000001100000111D1111111111D1
11110111111111011100000000001 101
1111D111111111D11101010010001 101
11000000110101011100000Z10001 101
100000000Z000000000Z0000100X1 101
1000Z0000X00000011Z11100100011 11
1100000111010101111101111000101
110111111101011111111010001111
11111111 1111111 111111111111   1

