NO ./imgs/north.png
SO ./imgs/south.png
WE ./imgs/west.png
EA ./imgs/east.png


F 0,100,0
C 70,130,180


        111111111111111111111111
        100000000011000000001001
        1011000001100000W0001001
        1001000000D00000010000001
111111111D110000011100000100000X1
10000000001100000111D1111111111D1
11110111111111011100000000001 101
1111D111111111D11101010010001 101
11000000110101011100000010001 101
10000000000000000000000010001 101
100000000000000011011100100011 11
1100000111010101111101111000101
110111111101011111111010001111
11111111 1111111 111111111111   1

