NO ./imgs/north.xpm
SO ./imgs/south.xpm
WE ./imgs/west.xpm
EA ./imgs/east.xpm


F 0,100,0
C 70,130,180

1111111111111
1000000000001
1011111000001
1000000000001
1000000000001
1000000000001
100N000000001
1000000000001
1000000000001
1000000000001
1000000000001
1001110000001
1000000000001
1000000000001
1000000000001
1000000000101
1000000000001
1000000000001
1000000000001
11111100000Z1
1111111111111
